NO ./textures/01.png
SO ./textures/02.png
WE ./textures/03.png
EA ./textures/04.png
F 255,0,100
C 214, 50, 6


1111111111111111111111111
1000000000110000000000001
1011000001110001111000111
100100000000001100100001111111111
111111111011000111100W00000000001
100000000011000001110111100011111
11110111111111011100000010001
11110111111111011101010010001
1000000000000000110000010001
10000000000000001101010010001
11000001110101011111011110001
11110111 1110101 101111010001
11111111 1111111 111111111111