NO ./textures/Wall.png
SO ./textures/Wall.png
WE ./textures/Wall.png
EA ./textures/Wall.png
F 64,64,64
C 200,200,255


11111111111111111111111111111111111111111111111111111111111111111111111111111111
1X0X0000X0110000X00000X0000030000000X0000X0000X0000X0000X0000X0000X00000000003X1
101100X00X11000011100011X0111011100011100X1110001X1001110011100011X0011110011111
1001000000000011001000011111111110110001111000X0000X0000110001100000000000011111
1111111X101100011110000000000000111000001110011111001111011X11X01110001111111111
1000000000110000011101111000111111100010001110000010X0011100000001100000000X0001
11110111111111011100000030001110011110101110101010011110011111111110111111111111
11110111111111N111010100100011100100X0000110000110010010101010010101010010100111
1000000000000000030000010001100011000011100000110X0110001000001100000000000X0001
1000X000000000001101010010001110101000101010100111010101001010101010010100100X11
11000001110101011111011110001111101111101111101111101110111110111110111101111111
1111011111101011010111100010X101110010101010010111010111010101011010101110111101
11111111111111111111111111111111111111111111111111111111111111111111111111111111